Script started on 2020-09-24 16:45:34-04:00 [TERM="xterm" TTY="/dev/pts/7" COLUMNS="93" LINES="49"]
psammon1@remote07:~/i220a/submit/lab1$ git pushmerge lab4 -m 'merged lab4'[12Pcheckout masterpush[Kcommit -a -m 'completing lab4'push[Kcheckout mastermerge lab4 -m 'merged lab4'push[K[Kcd ~/cs220/labs/lab1/exercises/3-multifile/
psammon1@remote07:~/cs220/labs/lab1/exercises/3-multifile$ vim Makefie
[?1000h[?2004h[?1049h[22;0;0t[?1h=[?2004h[1;49r[?12h[?12l[22;2t[22;1t[27m[23m[29m[m[H[2J[?25l[49;1H"Makefie" [New File][2;1H▽[6n[2;1H  [1;1H[>c]10;?]11;?[2;1H[1m[34m~                                                                                            [3;1H~                                                                                            [4;1H~                                                                                            [5;1H~                                                                                            [6;1H~                                                                                            [7;1H~                                                                                            [8;1H~                                                                                            [9;1H~                                                                                            [10;1H~                                                                                            [11;1H~                                                                                            [12;1H~                                                                                            [13;1H~                                                                                            [14;1H~                                                                                            [15;1H~                                                                                            [16;1H~                                                                                            [17;1H~                                                                                            [18;1H~                                                                                            [19;1H~                                                                                            [20;1H~                                                                                            [21;1H~                                                                                            [22;1H~                                                                                            [23;1H~                                                                                            [24;1H~                                                                                            [25;1H~                                                                                            [26;1H~                                                                                            [27;1H~                                                                                            [28;1H~                                                                                            [29;1H~                                                                                            [30;1H~                                                                                            [31;1H~                                                                                            [32;1H~                                                                                            [33;1H~                                                                                            [34;1H~                                                                                            [35;1H~                                                                                            [36;1H~                                                                                            [37;1H~                                                                                            [38;1H~                                                                                            [39;1H~                                                                                            [40;1H~                                                                                            [41;1H~                                                                                            [42;1H~                                                                                            [43;1H~                                                                                            [44;1H~                                                                                            [45;1H~                                                                                            [46;1H~                                                                                            [47;1H~                                                                                            [48;1H~                                                                                            [m[49;76H0,0-1[9CAll[1;1H[?25h[?1000l[?1002h[?25l[49;66H^[[1;1H[49;66H  [1;1H[49;66H^[[1;1H[49;66H  [1;1H[?25h[?25l[49;66H:[1;1H[49;1H[K[49;1H:[?2004h[?25hw[?25l[?25hq[?25l[?25h[?25l[?1002l[?2004l"Makefie" [New] 0L, 0C written[23;2t[23;1t[22;2t[22;1t[23;2t[23;1t
[?2004l[?1l>[?25h[?1049l[23;0;0tpsammon1@remote07:~/cs220/labs/lab1/exercises/3-multifile$ vim Makefie[K[K[K[K[K[K[K[K[K[K[Kls
main.c	main.o	Makefie  Makefile  quadr  quadr.c  quadr.h  quadr.o  README  test.data
psammon1@remote07:~/cs220/labs/lab1/exercises/3-multifile$ rm make[K[K[K[KMakefie
psammon1@remote07:~/cs220/labs/lab1/exercises/3-multifile$ rm Makefie[K[Kills[Kvim Makefie[Kle
[?1000h[?2004h[?1049h[22;0;0t[?1h=[?2004h[1;49r[?12h[?12l[22;2t[22;1t[27m[23m[29m[m[H[2J[?25l[49;1H"Makefile" 11L, 178C[2;1H▽[6n[2;1H  [1;1H[>c]10;?]11;?[1;1H[36mPROJECT [m= quadr

[36mCFLAGS [m= -g -Wall -std=c11
[36mLDFLAGS [m= -lm

[36m$(PROJECT):[m     quadr.o main.o
[31m                [m[36m$(CC)[m[31m [m[36m$(LDFLAGS)[m[31m quadr.o main.o -o [m[36m$@

clean:[m
[31m                rm -f *.o [m[36m$(PROJECT)[m[31m [m[36m$(PROJECT)[m[31m.tar.gz[m

[1m[34m~                                                                                            [13;1H~                                                                                            [14;1H~                                                                                            [15;1H~                                                                                            [16;1H~                                                                                            [17;1H~                                                                                            [18;1H~                                                                                            [19;1H~                                                                                            [20;1H~                                                                                            [21;1H~                                                                                            [22;1H~                                                                                            [23;1H~                                                                                            [24;1H~                                                                                            [25;1H~                                                                                            [26;1H~                                                                                            [27;1H~                                                                                            [28;1H~                                                                                            [29;1H~                                                                                            [30;1H~                                                                                            [31;1H~                                                                                            [32;1H~                                                                                            [33;1H~                                                                                            [34;1H~                                                                                            [35;1H~                                                                                            [36;1H~                                                                                            [37;1H~                                                                                            [38;1H~                                                                                            [39;1H~                                                                                            [40;1H~                                                                                            [41;1H~                                                                                            [42;1H~                                                                                            [43;1H~                                                                                            [44;1H~                                                                                            [45;1H~                                                                                            [46;1H~                                                                                            [47;1H~                                                                                            [48;1H~                                                                                            [m[49;76H4,14[10CAll[4;14H[?25h[?1000l[?1002h[?25l[49;76H7,9-23[7;23H[?25h[?25l[49;66Hi[7;23H[49;66H [7;23H[49;1H[1m-- INSERT --[m[49;13H[K[49;76H7,9-23[8CAll[7;23H[?25h[?25l[49;78H38-52[7;52H[?25h[?25l[49;79H2-46[7;46H[?25h[?25l[49;76H6,27-31[6;31H[?25h[?25l[49;79H8-32[6;32H[?25h[?25l$[49;79H9-33[6;33H[?25h[?25l[36m$([m[49;78H30-34[6;34H[?25h[?25l[36mL[m[49;79H1-35[6;35H[?25h[?25l[36mD[m[49;79H2-36[6;36H[?25h[?25l[36mF[m[49;79H3-37[6;37H[?25h[?25l[36mL[m[49;79H4-38[6;38H[?25h[?25l[36mA[m[49;79H5-39[6;39H[?25h[?25l[36mG[m[49;79H6-40[6;40H[?25h[?25l[36mS[m[49;79H7-41[6;41H[?25h[?25l[36m)[m[6;33H[36m[46m([7C)[m[49;79H8-42[6;42H[?25h[?25l[6;33H[36m([7C)[m[7;24H[36m[46m([7C)[m[49;76H7,18-3[7;32H[?25h[?25l[49;79H9-33[7;33H[?25h[?25l[36m[46m [m[36mquadr.o main.o -o $@[m[7;53H[K[10;1H[36m                rm -f *.o [10C [10C.tar.gz[7;24H([7C [m[49;79H8-32[7;32H[?25h[?25l[1C[36m quadr.o main.o -o $@[m[49;79H9-33[7;33H[?25h[?25l[36mquadr.o main.o -o $@[m[7;53H[K[49;79H8-32[7;32H[?25h[?25l[1C[36m quadr.o main.o -o $@[m[49;79H9-33[7;33H[?25h[?25l[49;79H8-32[7;32H[?25h[?25l[36m  quadr.o main.o -o $@[m[7;53H[K[49;79H7-31[7;31H[?25h[?25l[36m  quadr.o main.o -o $@[m[7;52H[K[49;79H6-30[7;30H[?25h[?25l[36m  quadr.o main.o -o $@[m[7;51H[K[49;79H5-29[7;29H[?25h[?25l[36m  quadr.o main.o -o $@[m[7;50H[K[49;79H4-28[7;28H[?25h[?25l[36m  quadr.o main.o -o $@[m[7;49H[K[49;79H3-27[7;27H[?25h[?25l[36m  quadr.o main.o -o $@[m[7;48H[K[49;79H2-26[7;26H[?25h[?25l[36m  quadr.o main.o -o $@[m[7;47H[K[49;79H1-25[7;25H[?25h[?25l[36m [m[31m quadr.o main.o -o [m[36m$@[m[7;46H[K[10;1H[31m                rm -f *.o [10C [10C.tar.gz[m[49;79H0-24[7;24H[?25h[?25l[31m  quadr.o main.o -o [m[36m$@[m[7;45H[K[49;78H9-23 [7;23H[?25h[?25l[1C[31mquadr.o main.o -o [m[36m$@[m[7;44H[K[7;18H[36m[46m([2C)[m[49;78H8-22[7;22H[?25h[?25l[36m(CC)[m[49;76H5,1   [5;1H[?25h[?25l[49;76H7,9-23[7;23H[?25h[49;1H[K[7;22H[?25l[49;66H^[[7;22H[49;66H  [7;23H[49;76H7,8-22[8CAll[7;22H[?25h[?25l[49;66H:[7;22H[49;66H[K[49;1H:[?2004h[?25hw[?25l[?25hq[?25l[?25h[?25l[?1002l[?2004l"Makefile" 11L, 179C written[23;2t[23;1t[22;2t[22;1t[23;2t[23;1t
[?2004l[?1l>[?25h[?1049l[23;0;0tpsammon1@remote07:~/cs220/labs/lab1/exercises/3-multifile$ make
make: 'quadr' is up to date.
psammon1@remote07:~/cs220/labs/lab1/exercises/3-multifile$ ./[K[Kls
main.c	main.o	Makefile  quadr  quadr.c  quadr.h  quadr.o  README  test.data
psammon1@remote07:~/cs220/labs/lab1/exercises/3-multifile$ ./quadr
2 3 5
a = 2, b = 3, c = 5, root1 = -nan, root2 = -nan
./quadr < test.data
<stdin>:2: must have 3 doubles: bad input line ./quadr < test.data
psammon1@remote07:~/cs220/labs/lab1/exercises/3-multifile$ ./quadr
1 -3 4
a = 1, b = -3, c = 4, root1 = -nan, root2 = -nan
1 3 4
a = 1, b = 3, c = 4, root1 = -nan, root2 = -nan
psammon1@remote07:~/cs220/labs/lab1/exercises/3-multifile$ ls
main.c	main.o	Makefile  quadr  quadr.c  quadr.h  quadr.o  README  test.data
psammon1@remote07:~/cs220/labs/lab1/exercises/3-multifile$ vim test.data
[?1000h[?2004h[?1049h[22;0;0t[?1h=[?2004h[1;49r[?12h[?12l[22;2t[22;1t[27m[23m[29m[m[H[2J[?25l[49;1H"test.data" 4L, 28C[2;1H▽[6n[2;1H  [1;1H[>c]10;?]11;?[1;1H2 6 4
1 5 -2
2 3 4 5
1 2+ 3
[1m[34m~                                                                                            [6;1H~                                                                                            [7;1H~                                                                                            [8;1H~                                                                                            [9;1H~                                                                                            [10;1H~                                                                                            [11;1H~                                                                                            [12;1H~                                                                                            [13;1H~                                                                                            [14;1H~                                                                                            [15;1H~                                                                                            [16;1H~                                                                                            [17;1H~                                                                                            [18;1H~                                                                                            [19;1H~                                                                                            [20;1H~                                                                                            [21;1H~                                                                                            [22;1H~                                                                                            [23;1H~                                                                                            [24;1H~                                                                                            [25;1H~                                                                                            [26;1H~                                                                                            [27;1H~                                                                                            [28;1H~                                                                                            [29;1H~                                                                                            [30;1H~                                                                                            [31;1H~                                                                                            [32;1H~                                                                                            [33;1H~                                                                                            [34;1H~                                                                                            [35;1H~                                                                                            [36;1H~                                                                                            [37;1H~                                                                                            [38;1H~                                                                                            [39;1H~                                                                                            [40;1H~                                                                                            [41;1H~                                                                                            [42;1H~                                                                                            [43;1H~                                                                                            [44;1H~                                                                                            [45;1H~                                                                                            [46;1H~                                                                                            [47;1H~                                                                                            [48;1H~                                                                                            [m[49;76H1,1[11CAll[1;1H[?25h[?1000l[?1002h[?25l[49;76H4,6[4;6H[?25h[?25l[49;78H5[4;5H[?25h[?25l[49;66H~@k[4;5H[49;66H   [4;4H[49;78H4[4;4H[?25h[?25l[49;66Hi[4;4H[49;66H [4;4H[49;1H[1m-- INSERT --[m[49;13H[K[49;76H4,4[11CAll[4;4H[?25h[?25l[49;78H5[4;5H[?25h[?25l 3[4;6H[K[49;78H4[4;4H[?25h[?25l[49;78H6[4;6H[?25h[49;1H[K[4;5H[?25l[49;66H^[[4;5H[49;66H  [4;6H[49;76H4,5[11CAll[4;5H[?25h[?25l[49;66H^[[4;5H[49;66H  [4;5H[49;66H^[[4;5H[49;66H  [4;5H[?25h[?25l[49;66H:[4;5H[49;66H[K[49;1H:[?2004h[?25hw[?25l[?25hq[?25l[?25h[?25l[?1002l[?2004l"test.data" 4L, 27C written[23;2t[23;1t[22;2t[22;1t[23;2t[23;1t
[?2004l[?1l>[?25h[?1049l[23;0;0tpsammon1@remote07:~/cs220/labs/lab1/exercises/3-multifile$ vim test.datals[K./quadrls[Kmakevim Makefile[2Prm Makefills[Kvim Makefiecd ~/cs220/labs/lab1/exercises/3-multifile/[A[C[C[C[C[C[C[C[C[C[C[C[C[C[C[C[C[C[C[C[C[C[C[C[C[C[C[C[C[C[C[C[C[C[C[C[C[C[C[C[C[C[C[C[C[C[C[C[C[C[Cgit push[K
[K[A[C[C[C[C[C[C[C[C[C[C[C[C[C[C[C[C[C[C[C[C[C[C[C[C[C[C[C[C[C[C[C[C[C[C[C[C[C[C[C[C[C[C[C[C[C[C[C[C[C[C[C[C[C[C[C[C[C[C[C[C[C[C[C[C[C[C[Cmerge lab4 -m 'merged lab4'[12Pcheckout mastermerge lab4 -m 'merged lab4'push[Kcd ~/cs220/labs/lab1/exercises/3-multifile/[A[C[C[C[C[C[C[C[C[C[C[C[C[C[C[C[C[C[C[C[C[C[C[C[C[C[C[C[C[C[C[C[C[C[C[C[C[C[C[C[C[C[C[C[C[C[C[C[C[C[Cvim Makefie[K
[K[A[C[C[C[C[C[C[C[C[C[C[C[C[C[C[C[C[C[C[C[C[C[C[C[C[C[C[C[C[C[C[C[C[C[C[C[C[C[C[C[C[C[C[C[C[C[C[C[C[C[C[C[C[C[C[C[C[C[C[C[C[C[C[C[C[C[C[C[C[C[Cls[Krm Makefilvim Makefile[8Pmake[2Pls./quadrls[Kvim test.data[Kvim test.datals[K./quadr < test.data
a = 2, b = 6, c = 4, root1 = -1, root2 = -2
a = 1, b = 5, c = -2, root1 = 0.372281, root2 = -5.37228
a = 2, b = 3, c = 4, root1 = -nan, root2 = -nan
a = 1, b = 2, c = 3, root1 = -nan, root2 = -nan
psammon1@remote07:~/cs220/labs/lab1/exercises/3-multifile$ touch[K[K[K[K[Kmake
make: 'quadr' is up to date.
psammon1@remote07:~/cs220/labs/lab1/exercises/3-multifile$ vim Makefile
[?1000h[?2004h[?1049h[22;0;0t[?1h=[?2004h[1;49r[?12h[?12l[22;2t[22;1t[27m[23m[29m[m[H[2J[?25l[49;1H"Makefile" 11L, 179C[2;1H▽[6n[2;1H  [1;1H[>c]10;?]11;?[1;1H[36mPROJECT [m= quadr

[36mCFLAGS [m= -g -Wall -std=c11
[36mLDFLAGS [m= -lm

[36m$(PROJECT):[m     quadr.o main.o [36m$(LDFLAGS)[m
[31m                [m[36m$(CC)[m[31m  quadr.o main.o -o [m[36m$@

clean:[m
[31m                rm -f *.o [m[36m$(PROJECT)[m[31m [m[36m$(PROJECT)[m[31m.tar.gz[m

[1m[34m~                                                                                            [13;1H~                                                                                            [14;1H~                                                                                            [15;1H~                                                                                            [16;1H~                                                                                            [17;1H~                                                                                            [18;1H~                                                                                            [19;1H~                                                                                            [20;1H~                                                                                            [21;1H~                                                                                            [22;1H~                                                                                            [23;1H~                                                                                            [24;1H~                                                                                            [25;1H~                                                                                            [26;1H~                                                                                            [27;1H~                                                                                            [28;1H~                                                                                            [29;1H~                                                                                            [30;1H~                                                                                            [31;1H~                                                                                            [32;1H~                                                                                            [33;1H~                                                                                            [34;1H~                                                                                            [35;1H~                                                                                            [36;1H~                                                                                            [37;1H~                                                                                            [38;1H~                                                                                            [39;1H~                                                                                            [40;1H~                                                                                            [41;1H~                                                                                            [42;1H~                                                                                            [43;1H~                                                                                            [44;1H~                                                                                            [45;1H~                                                                                            [46;1H~                                                                                            [47;1H~                                                                                            [48;1H~                                                                                            [m[49;76H7,8-22[8CAll[7;22H[?25h[?1000l[?1002h[?25l[49;66Hi[7;22H[49;66H [7;22H[49;1H[1m-- INSERT --[m[49;13H[K[49;76H7,8-22[8CAll[7;22H[?25h[?25l[6;33H[36m[46m([7C)[m[49;76H6,38-42[6;42H[?25h[?25l[6;33H[36m([7C)[m[49;76H7,30-44[7;44H[?25h[?25l[8;48r[8;1H[L[1;49r[8;1H[31m                [m[49;76H[K[49;76H8,3-17[8CAll[8;17H[?25h[?25l[8;9H[K[49;78H2-9 [8;9H[?25h[?25l[8;1H[K[49;78H1  [8;1H[?25h[?25l[7;48r[48;1H
[1;49r[7;1H[31m                [m[36m$(CC)[m[31m  quadr.o main.o -o [m[36m$@[m[48;1H[1m[34m~                                                                                            [m[49;76H[K[49;76H7,30-44[7CAll[7;44H[?25h[?25l[8;48r[8;1H[L[1;49r[8;1H[31m                [m[49;76H[K[49;76H8,3-17[8CAll[8;17H[?25h[?25l[8;9H[K[49;78H2-9 [8;9H[?25h[?25l[8;1H[K[49;78H1  [8;1H[?25h[?25l[9;48r[9;1H[L[1;49r[49;76H[K[49;76H9,1[11CAll[9;1H[?25h[?25ld[49;78H2[9;2H[?25h[?25le[49;78H3[9;3H[?25h[?25lp[49;78H4[9;4H[?25h[?25le[49;78H5[9;5H[?25h[?25ln[49;78H6[9;6H[?25h[?25ld[49;78H7[9;7H[?25h[?25l[36mdepend:[m[49;78H8[9;8H[?25h[?25l[10;48r[10;1H[L[1;49r[10;1H[31m        [m[49;76H[K[49;76H10,2-9[8CAll[10;9H[?25h[?25l[31m$[m[49;79H3-10[10;10H[?25h[?25l[36m$(


                rm -f *.o [10C [10C.tar.gz[m[49;79H4-11[10;11H[?25h[?25l[36mC[m[49;79H5-12[10;12H[?25h[?25l[36mC[m[49;79H6-13[10;13H[?25h[?25l[36m)[m


[31m                rm -f *.o [10C [10C.tar.gz[m[10;10H[36m[46m([2C)[m[49;79H7-14[10;14H[?25h[?25l[10;13H[K[13;1H[36m                rm -f *.o [10C [10C.tar.gz[10;10H([m[49;79H6-13[10;13H[?25h[?25l[36m)[m


[31m                rm -f *.o [10C [10C.tar.gz[m[10;10H[36m[46m([2C)[m[49;79H7-14[10;14H[?25h[?25l[31m [m[36m(CC)[m[49;79H8-15[10;15H[?25h[?25l[31m-[m[49;79H9-16[10;16H[?25h[?25l[31mM[m[49;79H10-17[10;17H[?25h[?25l[31mM[m[49;80H1-18[10;18H[?25h[?25l[31m [m[49;80H2-19[10;19H[?25h[?25l[31m$[m[49;80H3-20[10;20H[?25h[?25l[36m$(


                rm -f *.o [10C [10C.tar.gz[m[49;80H4-21[10;21H[?25h[?25l[36mC[m[49;80H5-22[10;22H[?25h[?25l[36mP[m[49;80H6-23[10;23H[?25h[?25l[36mP[m[49;80H7-24[10;24H[?25h[?25l[36mF[m[49;80H8-25[10;25H[?25h[?25l[36mL[m[49;80H9-26[10;26H[?25h[?25l[36mA[m[49;79H20-27[10;27H[?25h[?25l[36mG[m[49;80H1-28[10;28H[?25h[?25l[36mS[m[49;80H2-29[10;29H[?25h[?25l[36m)[m


[31m                rm -f *.o [10C [10C.tar.gz[m[10;20H[36m[46m([8C)[m[49;80H3-30[10;30H[?25h[?25l[31m [m[10;20H[36m([8C)[m[49;80H4-31[10;31H[?25h[?25l[31m*[m[49;80H5-32[10;32H[?25h[?25l[31m.[m[49;80H6-33[10;33H[?25h[?25l[31mc[m[49;80H7-34[10;34H[?25h[49;1H[K[10;33H[?25l[49;66H^[[10;33H[49;66H  [10;34H[49;76H10,26-33      All[10;33H[?25h[?25l[49;66H:[10;33H[49;66H[K[49;1H:[?2004h[?25hw[?25l[?25hq[?25l[?25h[?25l[?1002l[?2004l"Makefile" 14L, 215C written[23;2t[23;1t[22;2t[22;1t[23;2t[23;1t
[?2004l[?1l>[?25h[?1049l[23;0;0tpsammon1@remote07:~/cs220/labs/lab1/exercises/3-multifile$ make depend
cc -MM  *.c
main.o: main.c quadr.h
quadr.o: quadr.c quadr.h
psammon1@remote07:~/cs220/labs/lab1/exercises/3-multifile$ ^C
psammon1@remote07:~/cs220/labs/lab1/exercises/3-multifile$ main.o: main.c quadr.h
bash: main.o:: command not found
psammon1@remote07:~/cs220/labs/lab1/exercises/3-multifile$ quadr.o: quadr.c quadr.h
bash: quadr.o:: command not found
psammon1@remote07:~/cs220/labs/lab1/exercises/3-multifile$ vim Makefile
[?1000h[?2004h[?1049h[22;0;0t[?1h=[?2004h[1;49r[?12h[?12l[22;2t[22;1t[27m[23m[29m[m[H[2J[?25l[49;1H"Makefile" 14L, 215C[2;1H▽[6n[2;1H  [1;1H[>c]10;?]11;?[1;1H[36mPROJECT [m= quadr

[36mCFLAGS [m= -g -Wall -std=c11
[36mLDFLAGS [m= -lm

[36m$(PROJECT):[m     quadr.o main.o [36m$(LDFLAGS)[m
[31m                [m[36m$(CC)[m[31m  quadr.o main.o -o [m[36m$@

depend:[m
[31m        [m[36m$(CC)[m[31m -MM [m[36m$(CPPFLAGS)[m[31m *.c[m

[36mclean:[m
[31m                rm -f *.o [m[36m$(PROJECT)[m[31m [m[36m$(PROJECT)[m[31m.tar.gz[m

[1m[34m~                                                                                            [16;1H~                                                                                            [17;1H~                                                                                            [18;1H~                                                                                            [19;1H~                                                                                            [20;1H~                                                                                            [21;1H~                                                                                            [22;1H~                                                                                            [23;1H~                                                                                            [24;1H~                                                                                            [25;1H~                                                                                            [26;1H~                                                                                            [27;1H~                                                                                            [28;1H~                                                                                            [29;1H~                                                                                            [30;1H~                                                                                            [31;1H~                                                                                            [32;1H~                                                                                            [33;1H~                                                                                            [34;1H~                                                                                            [35;1H~                                                                                            [36;1H~                                                                                            [37;1H~                                                                                            [38;1H~                                                                                            [39;1H~                                                                                            [40;1H~                                                                                            [41;1H~                                                                                            [42;1H~                                                                                            [43;1H~                                                                                            [44;1H~                                                                                            [45;1H~                                                                                            [46;1H~                                                                                            [47;1H~                                                                                            [48;1H~                                                                                            [m[49;76H10,26-33      All[10;33H[?25h[?1000l[?1002h[?25l[49;66Hi[10;33H[49;66H [10;33H[49;1H[1m-- INSERT --[m[49;13H[K[49;76H10,26-33      All[10;33H[?25h[?25l[49;77H3,41-55[13;55H[?25h[?25l[14;48r[14;1H[L[1;49r[14;1H[31m                [m[49;76H[K[49;76H14,3-17[7CAll[14;17H[?25h[?25l[15;48r[15;1H[L[1;49r[14;1H[K[49;76H[K[49;76H15,1[10CAll[15;1H[?25h[?25l[49;4H[1m(insert)- VISUAL --[m[49;76H[K[49;66H1[15;1H[49;76H15,0-1[8CAll[15;1H[?25h[?25l[?25h[?25l[49;66H^P[15;1H[49;66H2 [14;1H
[7m [m[49;77H4[14;1H[?25h[?25l[49;66Hp[14;1H[49;1H3 more lines[49;13H[K[15;1H[K[17;1H[K[49;1H[1m-- INSERT --[m[63C15,1[10CAll3 more lines [49;76H[K[15;1H[?25h[?25l[49;1H[1m-- INSERT --[m[63C15,1[10CAll[15;1Hp[49;79H2[15;2H[?25h[?25l[15;1H[K[49;79H1[15;1H[?25h[34m^[?25l[m[49;66H^V[15;1H[?25h [?25l[49;66H  [15;1H[34m^[[mOB[49;79H4-5[15;5H[?25h[?25l[49;77H6,2  [16;2H[?25h[?25l[49;77H7,1[17;1H[?25h[?25l[1m[34m~                                                                                            [m[49;77H6,2[16;2H[?25h[?25l[49;79H1[16;1H[?25h[?25l[1m[34m~                                                                                            [m[49;77H5,4-5[15;5H[?25h[?25l[15;4H[K[49;79H3-4[15;4H[?25h[?25l[15;3H[K[49;79H2-3[15;3H[?25h[?25l[15;1H[K[49;79H1  [15;1H[?25h[?25l[1m[34m~                                                                                            [m[49;77H4[14;1H[?25h[?25lm[49;79H2[14;2H[?25h[?25la[49;79H3[14;3H[?25h[?25li[49;79H4[14;4H[?25h[?25ln[49;79H5[14;5H[?25h[?25l.[49;79H6[14;6H[?25h[?25lo[49;79H7[14;7H[?25h[?25l[49;77H3,41-55[13;55H[?25h[?25l[14;48r[14;1H[L[1;49r[14;1H[31m                [m[49;76H[K[49;76H14,3-17[7CAll[14;17H[?25h[?25l[14;1H[K[49;77H5,7   [15;7H[?25h[?25l[36mmain.o:[m[49;79H8[15;8H[?25h[?25l
[31m        [m[16;9H[K[49;77H6,2-9[16;9H[?25h[?25l[16;1H[K[49;77H5,8  [15;8H[?25h[?25l[36m [m[49;79H9[15;9H[?25h[?25l[15;8H[K[49;79H8[15;8H[?25h[?25l[36m [m[49;79H9[15;9H[?25h[?25l[36m        [m[49;79H10-17[15;17H[?25h[?25l[15;8H         m[49;80H1-18[15;18H[?25h[?25la[49;80H2-19[15;19H[?25h[?25li[49;80H3-20[15;20H[?25h[?25ln[49;80H4-21[15;21H[?25h[?25l.[49;80H5-22[15;22H[?25h[?25lc[49;80H6-23[15;23H[?25h[?25l[49;80H7-24[15;24H[?25h[?25lq[49;80H8-25[15;25H[?25h[?25lu[49;80H9-26[15;26H[?25h[?25la[49;79H20-27[15;27H[?25h[?25ld[49;80H1-28[15;28H[?25h[?25lr[49;80H2-29[15;29H[?25h[?25l.[49;80H3-30[15;30H[?25h[?25lh[49;80H4-31[15;31H[?25h[?25l[16;48r[16;1H[L[1;49r[16;1H[31m        [m[49;76H[K[49;76H16,2-9[8CAll[16;9H[?25h[?25l[17;48r[17;1H[L[1;49r[16;1H[K[49;76H[K[49;76H17,1[10CAll[17;1H[?25h[?25lq[49;79H2[17;2H[?25h[?25lu[49;79H3[17;3H[?25h[?25la[49;79H4[17;4H[?25h[?25ld[49;79H5[17;5H[?25h[?25lr[49;79H6[17;6H[?25h[?25l.[49;79H7[17;7H[?25h[?25lo[49;79H8[17;8H[?25h[?25l[36mquadr.o:[m[49;79H9[17;9H[?25h[?25l[36m        [m[49;79H10-17[17;17H[?25h[?25l[36m        [m[49;80H1-25[17;25H[?25h[?25l[17;17H[K[49;80H0-17[17;17H[?25h[?25l[17;9H        q[49;80H1-18[17;18H[?25h[?25lu[49;80H2-19[17;19H[?25h[?25la[49;80H3-20[17;20H[?25h[?25lr[49;80H4-21[17;21H[?25h[?25l[17;20H[K[49;80H3-20[17;20H[?25h[?25ld[49;80H4-21[17;21H[?25h[?25lr[49;80H5-22[17;22H[?25h[?25l.[49;80H6-23[17;23H[?25h[?25lc[49;80H7-24[17;24H[?25h[?25l[49;80H8-25[17;25H[?25h[?25lq[49;80H9-26[17;26H[?25h[?25lu[49;79H20-27[17;27H[?25h[?25la[49;80H1-28[17;28H[?25h[?25ld[49;80H2-29[17;29H[?25h[?25lr[49;80H3-30[17;30H[?25h[?25l.[49;80H4-31[17;31H[?25h[?25lh[49;80H5-32[17;32H[?25h[?25l[18;48r[18;1H[L[1;49r[18;1H[31m        [m[49;76H[K[49;76H18,2-9[8CAll[18;9H[?25h[?25l[18;1H[K[49;77H6,1  [16;1H[?25h[?25l[49;77H5,24-31[15;31H[?25h[?25l[16;48r[16;1H[L[1;49r[16;1H[31m        [m[49;76H[K[49;76H16,2-9[8CAll[16;9H[?25h[?25l[31m        [m[49;79H3-17[16;17H[?25h[?25l[31mg[m[49;79H4-18[16;18H[?25h[?25l[31mc[m[49;79H5-19[16;19H[?25h[?25l[31mc[m[49;79H6-20[16;20H[?25h[?25l[31m [m[49;79H7-21[16;21H[?25h[?25l[31m-[m[49;79H8-22[16;22H[?25h[?25l[31ms[m[49;79H9-23[16;23H[?25h[?25l[31mt[m[49;79H10-24[16;24H[?25h[?25l[31md[m[49;80H1-25[16;25H[?25h[?25l[31m=[m[49;80H2-26[16;26H[?25h[?25l[31mc[m[49;80H3-27[16;27H[?25h[?25l[31m1[m[49;80H4-28[16;28H[?25h[?25l[31m1[m[49;80H5-29[16;29H[?25h[?25l[31m [m[49;80H6-30[16;30H[?25h[?25l[31m-[m[49;80H7-31[16;31H[?25h[?25l[31mg[m[49;80H8-32[16;32H[?25h[?25l[31m [m[49;80H9-33[16;33H[?25h[?25l[31m-[m[49;79H20-34[16;34H[?25h[?25l[31mW[m[49;80H1-35[16;35H[?25h[?25l[31ma[m[49;80H2-36[16;36H[?25h[?25l[31ma[m[49;80H3-37[16;37H[?25h[?25l[16;36H[K[49;80H2-36[16;36H[?25h[?25l[31ml[m[49;80H3-37[16;37H[?25h[?25l[31ml[m[49;80H4-38[16;38H[?25h[?25l[31m [m[49;80H5-39[16;39H[?25h[?25l[31m-[m[49;80H6-40[16;40H[?25h[?25l[31mc[m[49;80H7-41[16;41H[?25h[?25l[31m [m[49;80H8-42[16;42H[?25h[?25l[31mm[m[49;80H9-43[16;43H[?25h[?25l[31ma[m[49;79H30-44[16;44H[?25h[?25l[31mi[m[49;80H1-45[16;45H[?25h[?25l[31mn[m[49;80H2-46[16;46H[?25h[?25l[31m.[m[49;80H3-47[16;47H[?25h[?25l[31mc[m[49;80H4-48[16;48H[?25h[?25l[49;77H9,1    [19;1H[?25h[?25l[31m        [m[49;79H2-9[19;9H[?25h[?25l[31m        [m[49;79H3-17[19;17H[?25h[?25l[31mg[m[49;79H4-18[19;18H[?25h[?25l[31mc[m[49;79H5-19[19;19H[?25h[?25l[31mc[m[49;79H6-20[19;20H[?25h[?25l[31m [m[49;79H7-21[19;21H[?25h[?25l[31m-[m[49;79H8-22[19;22H[?25h[?25l[31ms[m[49;79H9-23[19;23H[?25h[?25l[31mt[m[49;79H10-24[19;24H[?25h[?25l[31md[m[49;80H1-25[19;25H[?25h[?25l[31m=[m[49;80H2-26[19;26H[?25h[?25l[31mc[m[49;80H3-27[19;27H[?25h[?25l[31m1[m[49;80H4-28[19;28H[?25h[?25l[31m1[m[49;80H5-29[19;29H[?25h[?25l[19;28H[K[49;80H4-28[19;28H[?25h[?25l[19;27H[K[49;80H3-27[19;27H[?25h[?25l[31ml[m[49;80H4-28[19;28H[?25h[?25l[31ml[m[49;80H5-29[19;29H[?25h[?25l[19;28H[K[49;80H4-28[19;28H[?25h[?25l[19;27H[K[49;80H3-27[19;27H[?25h[?25l[31m1[m[49;80H4-28[19;28H[?25h[?25l[31m1[m[49;80H5-29[19;29H[?25h[?25l[31m [m[49;80H6-30[19;30H[?25h[?25l[31m-[m[49;80H7-31[19;31H[?25h[?25l[31mg[m[49;80H8-32[19;32H[?25h[?25l[31m [m[49;80H9-33[19;33H[?25h[?25l[31m-[m[49;79H20-34[19;34H[?25h[?25l[31mW[m[49;80H1-35[19;35H[?25h[?25l[31ma[m[49;80H2-36[19;36H[?25h[?25l[31ml[m[49;80H3-37[19;37H[?25h[?25l[31ml[m[49;80H4-38[19;38H[?25h[?25l[31m [m[49;80H5-39[19;39H[?25h[?25l[31m-[m[49;80H6-40[19;40H[?25h[?25l[31mc[m[49;80H7-41[19;41H[?25h[?25l[31m [m[49;80H8-42[19;42H[?25h[?25l[31mq[m[49;80H9-43[19;43H[?25h[?25l[31mu[m[49;79H30-44[19;44H[?25h[?25l[31ma[m[49;80H1-45[19;45H[?25h[?25l[31md[m[49;80H2-46[19;46H[?25h[?25l[31mr[m[49;80H3-47[19;47H[?25h[?25l[31m.[m[49;80H4-48[19;48H[?25h[?25l[31mc[m[49;80H5-49[19;49H[?25h[?25l[49;77H4,1    [14;1H[?25h[?25l[15;48r[15;1H[L[1;49r[49;76H[K[49;76H15,1[10CAll[15;1H[?25h[?25l[34m#[m[49;79H2[15;2H[?25h[?25l[34ma[m[49;79H3[15;3H[?25h[?25l[34mu[m[49;79H4[15;4H[?25h[?25l[34mt[m[49;79H5[15;5H[?25h[?25l[34mo[m[49;79H6[15;6H[?25h[?25l[34mm[m[49;79H7[15;7H[?25h[?25l[34ma[m[49;79H8[15;8H[?25h[?25l[34mt[m[49;79H9[15;9H[?25h[?25l[34mi[m[49;79H10[15;10H[?25h[?25l[34mc[m[49;80H1[15;11H[?25h[?25l[34ma[m[49;80H2[15;12H[?25h[?25l[34ml[m[49;80H3[15;13H[?25h[?25l[34ml[m[49;80H4[15;14H[?25h[?25l[34my[m[49;80H5[15;15H[?25h[?25l[34m [m[49;80H6[15;16H[?25h[?25l[34mg[m[49;80H7[15;17H[?25h[?25l[34me[m[49;80H8[15;18H[?25h[?25l[34mn[m[49;80H9[15;19H[?25h[?25l[34me[m[49;79H20[15;20H[?25h[?25l[34mr[m[49;80H1[15;21H[?25h[?25l[34ma[m[49;80H2[15;22H[?25h[?25l[34mt[m[49;80H3[15;23H[?25h[?25l[34me[m[49;80H4[15;24H[?25h[?25l[34md[m[49;80H5[15;25H[?25h[?25l[34m [m[49;80H6[15;26H[?25h[?25l[34md[m[49;80H7[15;27H[?25h[?25l[34me[m[49;80H8[15;28H[?25h[?25l[34mp[m[49;80H9[15;29H[?25h[?25l[34me[m[49;79H30[15;30H[?25h[?25l[34mn[m[49;80H1[15;31H[?25h[?25l[34md[m[49;80H2[15;32H[?25h[?25l[34me[m[49;80H3[15;33H[?25h[?25l[34mc[m[49;80H4[15;34H[?25h[?25l[15;33H[K[49;80H3[15;33H[?25h[?25l[34mn[m[49;80H4[15;34H[?25h[?25l[34mc[m[49;80H5[15;35H[?25h[?25l[34mi[m[49;80H6[15;36H[?25h[?25l[34me[m[49;80H7[15;37H[?25h[?25l[34ms[m[49;80H8[15;38H[?25h[?25l[34m [m[49;80H9[15;39H[?25h[?25l[34mp[m[49;79H40[15;40H[?25h[?25l[34mo[m[49;80H1[15;41H[?25h[?25l[15;40H[K[49;80H0[15;40H[?25h[?25l[34mr[m[49;80H1[15;41H[?25h[?25l[34mo[m[49;80H2[15;42H[?25h[?25l[34md[m[49;80H3[15;43H[?25h[?25l[34mu[m[49;80H4[15;44H[?25h[?25l[34mc[m[49;80H5[15;45H[?25h[?25l[34me[m[49;80H6[15;46H[?25h[?25l[34md[m[49;80H7[15;47H[?25h[?25l[34m [m[49;80H8[15;48H[?25h[?25l[34mb[m[49;80H9[15;49H[?25h[?25l[34my[m[49;79H50[15;50H[?25h[?25l[34m [m[49;80H1[15;51H[?25h[?25l[34mm[m[49;80H2[15;52H[?25h[?25l[34ma[m[49;80H3[15;53H[?25h[?25l[34mk[m[49;80H4[15;54H[?25h[?25l[34me[m[49;80H5[15;55H[?25h[?25l[34m [m[49;80H6[15;56H[?25h[?25l[34md[m[49;80H7[15;57H[?25h[?25l[34me[m[49;80H8[15;58H[?25h[?25l[34mp[m[49;80H9[15;59H[?25h[?25l[34me[m[49;79H60[15;60H[?25h[?25l[34mn[m[49;80H1[15;61H[?25h[?25l[34md[m[49;80H2[15;62H[?25h[49;1H[K[15;61H[?25l[49;66H^[[15;61H[49;66H  [15;62H[49;76H15,61[9CAll[15;61H[?25h[?25l[49;66H:[15;61H[49;66H[K[49;1H:[?2004h[?25hw[?25l[?25hq[?25l[?25h[?25l[?1002l[?2004l"Makefile" 21L, 397C written[23;2t[23;1t[22;2t[22;1t[23;2t[23;1t
[?2004l[?1l>[?25h[?1049l[23;0;0tpsammon1@remote07:~/cs220/labs/lab1/exercises/3-multifile$ make
make: 'quadr' is up to date.
psammon1@remote07:~/cs220/labs/lab1/exercises/3-multifile$ makevim Makefile
[?1000h[?2004h[?1049h[22;0;0t[?1h=[?2004h[1;49r[?12h[?12l[22;2t[22;1t[27m[23m[29m[m[H[2J[?25l[49;1H"Makefile" 21L, 397C[2;1H▽[6n[2;1H  [1;1H[>c]10;?]11;?[1;1H[36mPROJECT [m= quadr

[36mCFLAGS [m= -g -Wall -std=c11
[36mLDFLAGS [m= -lm

[36m$(PROJECT):[m     quadr.o main.o [36m$(LDFLAGS)[m
[31m                [m[36m$(CC)[m[31m  quadr.o main.o -o [m[36m$@

depend:[m
[31m        [m[36m$(CC)[m[31m -MM [m[36m$(CPPFLAGS)[m[31m *.c[m

[36mclean:[m
[31m                rm -f *.o [m[36m$(PROJECT)[m[31m [m[36m$(PROJECT)[m[31m.tar.gz[m

[34m#automatically generated dependencies produced by make depend[m
[36mmain.o:[m[9Cmain.c quadr.h
[31m                gcc -std=c11 -g -Wall -c main.c[m

[36mquadr.o:[m[8Cquadr.c quadr.h
[31m                gcc -std=c11 -g -Wall -c quadr.c[m

[1m[34m~                                                                                            [23;1H~                                                                                            [24;1H~                                                                                            [25;1H~                                                                                            [26;1H~                                                                                            [27;1H~                                                                                            [28;1H~                                                                                            [29;1H~                                                                                            [30;1H~                                                                                            [31;1H~                                                                                            [32;1H~                                                                                            [33;1H~                                                                                            [34;1H~                                                                                            [35;1H~                                                                                            [36;1H~                                                                                            [37;1H~                                                                                            [38;1H~                                                                                            [39;1H~                                                                                            [40;1H~                                                                                            [41;1H~                                                                                            [42;1H~                                                                                            [43;1H~                                                                                            [44;1H~                                                                                            [45;1H~                                                                                            [46;1H~                                                                                            [47;1H~                                                                                            [48;1H~                                                                                            [m[49;76H15,61[9CAll[15;61H[?25h[?1000l[?1002h[?25l[49;66Hi[15;61H[49;66H [15;61H[49;1H[1m-- INSERT --[m[49;13H[K[49;76H15,61[9CAll[15;61H[?25h[?25l[49;76H5,1  [5;1H[?25h[?25l[49;76H4,16[4;16H[?25h[?25l[5;48r[5;1H[L[1;49r[49;76H[K[49;76H5,1[11CAll[5;1H[?25h[?25lS[49;78H2[5;2H[?25h[?25lR[49;78H3[5;3H[?25h[?25lC[49;78H4[5;4H[?25h[?25l_[49;78H5[5;5H[?25h[?25lF[49;78H6[5;6H[?25h[?25lI[49;78H7[5;7H[?25h[?25lL[49;78H8[5;8H[?25h[?25lE[49;78H9[5;9H[?25h[?25lS[49;78H10[5;10H[?25h[?25l[49;79H1[5;11H[?25h[?25l[36mSRC_FILES [m=[49;79H2[5;12H[?25h[?25l[49;79H3[5;13H[?25h[?25lm[49;79H4[5;14H[?25h[?25la[49;79H5[5;15H[?25h[?25li[49;79H6[5;16H[?25h[?25ln[49;79H7[5;17H[?25h[?25l.[49;79H8[5;18H[?25h[?25lc[49;79H9[5;19H[?25h[?25l[49;78H20[5;20H[?25h[?25l[35m\[m[49;79H1[5;21H[?25h[?25l[5;20H[K[49;79H0[5;20H[?25h[?25l[35m\[m[49;79H1[5;21H[?25h[?25l\[49;79H2[5;22H[?25h[?25l[6;48r[6;1H[L[1;49r[49;76H[K[49;76H6,1[11CAll[6;1H[?25h[?25l[49;78H2-9[6;9H[?25h[?25l[49;78H3-17[6;17H[?25h[?25l[49;78H2-9 [6;9H[?25h[?25lq[49;78H3-10[6;10H[?25h[?25lu[49;78H4-11[6;11H[?25h[?25la[49;78H5-12[6;12H[?25h[?25ld[49;78H6-13[6;13H[?25h[?25lr[49;78H7-14[6;14H[?25h[?25l.[49;78H8-15[6;15H[?25h[?25lh[49;78H9-16[6;16H[?25h[?25l[49;78H10-17[6;17H[?25h[?25l[35m\[m[49;79H1-18[6;18H[?25h[?25l\[49;79H2-19[6;19H[?25h[?25l[35m\[m[49;79H1-18[6;18H[?25h[?25l[7;48r[7;1H[L[1;49r[7;1H[35m                [m[49;76H[K[49;76H7,3-17[8CAll[7;17H[?25h[?25l[7;9H[K[49;78H2-9 [7;9H[?25h[?25lq[49;78H3-10[7;10H[?25h[?25lu[49;78H4-11[7;11H[?25h[?25la[49;78H5-12[7;12H[?25h[?25ld[49;78H6-13[7;13H[?25h[?25lr[49;78H7-14[7;14H[?25h[?25l.[49;78H8-15[7;15H[?25h[?25lc[49;78H9-16[7;16H[?25h[?25l[49;78H10-17[7;17H[?25h[?25l[35m\[m[49;79H1-18[7;18H[?25h[?25l\[49;79H2-19[7;19H[?25h[?25l[35m\[m[49;79H1-18[7;18H[?25h[?25l[49;76H4,16   [4;16H[?25h[?25l[49;76H5,22[5;22H[?25h[?25l[35m\
        [m[49;79H1[5;21H[?25h[?25l[49;76H7,11-18[7;18H[?25h[?25l[8;48r[8;1H[L[1;49r[8;1H[35m        [m[49;76H[K[49;76H8,2-9[9CAll[8;9H[?25h[49;1H[K[8;1H[?25l[49;66H^[[8;1H[49;66H  [8;9H[8;1H[K[49;76H8,0-1[9CAll[8;1H[?25h[?25l[49;66H:[8;1H[49;66H[K[49;1H:[?2004h[?25hw[?25l[?25hq[?25l[?25h[?25l[?1002l[?2004l"Makefile" 25L, 441C written[23;2t[23;1t[22;2t[22;1t[23;2t[23;1t
[?2004l[?1l>[?25h[?1049l[23;0;0tpsammon1@remote07:~/cs220/labs/lab1/exercises/3-multifile$ ls
main.c	main.o	Makefile  quadr  quadr.c  quadr.h  quadr.o  README  test.data
psammon1@remote07:~/cs220/labs/lab1/exercises/3-multifile$ lsvim Makefile
[?1000h[?2004h[?1049h[22;0;0t[?1h=[?2004h[1;49r[?12h[?12l[22;2t[22;1t[27m[23m[29m[m[H[2J[?25l[49;1H"Makefile" 25L, 441C[2;1H▽[6n[2;1H  [1;1H[>c]10;?]11;?[1;1H[36mPROJECT [m= quadr

[36mCFLAGS [m= -g -Wall -std=c11
[36mLDFLAGS [m= -lm
[36mSRC_FILES [m= main.c [35m\
        [mquadr.h [35m\
        [mquadr.c [35m\[m


[36m$(PROJECT):[m     quadr.o main.o [36m$(LDFLAGS)[m
[31m                [m[36m$(CC)[m[31m  quadr.o main.o -o [m[36m$@

depend:[m
[31m        [m[36m$(CC)[m[31m -MM [m[36m$(CPPFLAGS)[m[31m *.c[m

[36mclean:[m
[31m                rm -f *.o [m[36m$(PROJECT)[m[31m [m[36m$(PROJECT)[m[31m.tar.gz[m

[34m#automatically generated dependencies produced by make depend[m
[36mmain.o:[m[9Cmain.c quadr.h
[31m                gcc -std=c11 -g -Wall -c main.c[m

[36mquadr.o:[m[8Cquadr.c quadr.h
[31m                gcc -std=c11 -g -Wall -c quadr.c[m

[1m[34m~                                                                                            [27;1H~                                                                                            [28;1H~                                                                                            [29;1H~                                                                                            [30;1H~                                                                                            [31;1H~                                                                                            [32;1H~                                                                                            [33;1H~                                                                                            [34;1H~                                                                                            [35;1H~                                                                                            [36;1H~                                                                                            [37;1H~                                                                                            [38;1H~                                                                                            [39;1H~                                                                                            [40;1H~                                                                                            [41;1H~                                                                                            [42;1H~                                                                                            [43;1H~                                                                                            [44;1H~                                                                                            [45;1H~                                                                                            [46;1H~                                                                                            [47;1H~                                                                                            [48;1H~                                                                                            [m[49;76H8,0-1[9CAll[8;1H[?25h[?1000l[?1002h[?25l[49;76H5,20 [5;20H[?25h[?25l[49;76H6,10-17[6;17H[?25h[?25l[49;76H7[7;17H[?25h[?25l[49;66H~@k[7;17H[49;66H   [7;17H[?25h[?25l[49;66H^M[7;17H[49;66H  [8;1H[49;76H8,0-1  [8;1H[?25h[?25l[49;66H^I[8;1H[49;66H  [8;1H[?25h[?25l[49;66Hi[8;1H[49;66H [8;1H[49;1H[1m-- INSERT --[m[49;13H[K[49;76H8,1[11CAll[8;1H[?25h[?25l[35m        [m[49;78H2-9[8;9H[?25h[?25lR[49;78H3-10[8;10H[?25h[?25lE[49;78H4-11[8;11H[?25h[?25lA[49;78H5-12[8;12H[?25h[?25lD[49;78H6-13[8;13H[?25h[?25lM[49;78H7-14[8;14H[?25h[?25lE[49;78H8-15[8;15H[?25h[?25l[49;78H9-16[8;16H[?25h[?25l[35m\[m[49;78H10-17[8;17H[?25h[?25l[9;48r[9;1H[L[1;49r[9;1H[35m        [m[49;76H[K[49;76H9,2-9[9CAll[9;9H[?25h[?25lt[49;78H3-10[9;10H[?25h[?25le[49;78H4-11[9;11H[?25h[?25ls[49;78H5-12[9;12H[?25h[?25lt[49;78H6-13[9;13H[?25h[?25l.[49;78H7-14[9;14H[?25h[?25ld[49;78H8-15[9;15H[?25h[?25la[49;78H9-16[9;16H[?25h[?25lt[49;78H10-17[9;17H[?25h[?25la[49;79H1-18[9;18H[?25h[?25l[49;79H2-19[9;19H[?25h[?25l[35m\[m[49;79H3-20[9;20H[?25h[?25l[10;48r[10;1H[L[1;49r[10;1H[35m        [m[49;76H[K[49;76H10,2-9[8CAll[10;9H[?25h[?25lm[49;79H3-10[10;10H[?25h[?25l[10;9H[K[49;79H2-9 [10;9H[?25h[?25lM[49;79H3-10[10;10H[?25h[?25la[49;79H4-11[10;11H[?25h[?25lk[49;79H5-12[10;12H[?25h[?25le[49;79H6-13[10;13H[?25h[?25lf[49;79H7-14[10;14H[?25h[?25li[49;79H8-15[10;15H[?25h[?25le[49;79H9-16[10;16H[?25h[?25l[10;15H[K[49;79H8-15[10;15H[?25h[?25ll[49;79H9-16[10;16H[?25h[?25le[49;79H10-17[10;17H[?25h[?25l[49;76H26,26-40[26;40H[?25h[?25l[31mic quadr.c[m[49;80H7-41[26;41H[?25h[?25l[31mc quadr.c[m[26;49H[K[49;80H6-40[26;40H[?25h[?25l[49;77H0,1    [20;1H[?25h[?25l[21;48r[21;1H[L[1;49r[49;76H[K[49;76H21,1[10CAll[21;1H[?25h[?25l[49;77H0[20;1H[?25h[?25l[21;48r[21;1H[L[1;49r[49;76H[K[49;76H21,1[10CAll[21;1H[?25h[?25l[49;77H0[20;1H[?25h[?25l[49;77H1[21;1H[?25h[?25l[22;48r[22;1H[5L[1;49r[21;1H[36mdist:[19C$(PROJECT)[m.tar.gz[23;5H[36m$(PROJECT)[m.tar.gz:[10C[36m$(SRC_FILES)[m[24;41Htar -cf [36m$(PROJECT)[m.tar [36m$(SRC_FILES)[m[25;73Hgzip -f [36m$(PROJECT)[m.taa[26;1Hr[49;76H[K[49;76H25,32-95      All[26;2H[?25h[?25l[49;77H3,4    [23;4H[?25h[?25l[24;48r[24;1H[L[1;49r[23;5H[K[24;4H[36m$(PROJECT)[m.tar.gz:[11C[36m$(SRC_FILES)[m[49;76H[K[49;76H24,3[10CAll[24;3H[?25h[?25l[36m$(PROJECT)[m.tar.gz: [49;79H2[24;2H[?25h[?25l[36m$(PROJECT)[m.tar.gz: [49;79H1[24;1H[?25h[?25l[23;48r[48;1H
[1;49r[23;2H   [36m$(PROJECT)[m.tar.gz:[48;1H[1m[34m~                                                                                            [m[49;76H[K[49;76H23,4[10CAll[23;4H[?25h[?25l[36m$(PROJECT)[m.tar.gz: [49;79H3[23;3H[?25h[?25l[36m$(PROJECT)[m.tar.gz: [49;79H2[23;2H[?25h[?25l[36m$(PROJECT)[m.tar.gz: [49;79H1[23;1H[?25h[?25l[33C[36m[46m([9C)[m[49;79H34-45[23;45H[?25h[?25l[23;34H[36m([9C)[m[49;77H4,13-33[24;33H[?25h[?25ltar -cf [36m$(PROJECT)[m.tar [36m$(SRC_FILES)[m[24;68H[K[49;80H2-25[24;25H[?25h[?25l[49;77H5,9-65 [25;65H[?25h[?25l[25;48r[48;1H
[1;49r[25;1H [63Cgzip -f [36m$(PROJECT)[m.tar[48;1H[1m[34m~                                                                                            [m[49;76H[K[49;76H25,8-57[7CAll[25;57H[?25h[?25lgzip -f [36m$(PROJECT)[m.tar[25;79H[K[49;79H7-49[25;49H[?25h[?25lgzip -f [36m$(PROJECT)[m.tar[25;71H[K[49;79H6-41[25;41H[?25h[?25lgzip -f [36m$(PROJECT)[m.tar[25;63H[K[49;79H5-33[25;33H[?25h[?25lgzip -f [36m$(PROJECT)[m.tar[25;55H[K[49;79H4-25[25;25H[?25h[?25l[49;79H27-55[25;55H[?25h[?25l[49;77H4,3    [24;3H[?25h[?25l[49;77H3,2[23;2H[?25h[?25l[49;79H1[23;1H[?25h[?25l[49;79H2[23;2H[?25h[?25l[36m$(PROJECT).tar.gz:[m [49;79H1[23;1H[?25h[?25l[49;77H1,8-17[21;17H[?25h[?25l[8C        [36m$(PROJECT)[m.tar.gz[49;79H9-25[21;25H[?25h[?25l[49;76H19,2-9 [19;9H[?25h[?25l[8C[31m        rm -f *.o [m[36m$(PROJECT)[m[31m [m[36m$(PROJECT)[m[31m.tar.gz[m[49;79H3-17[19;17H[?25h[?25l[8C[31m        rm -f *.o [m[36m$(PROJECT)[m[31m [m[36m$(PROJECT)[m[31m.tar.gz[m[49;79H4-25[19;25H[?25h[?25l[31mrm -f *.o [m[36m$(PROJECT)[m[31m [m[36m$(PROJECT)[m[31m.tar.gz[m[19;63H[K[49;79H3-17[19;17H[?25h[?25l[31mrm -f *.o [m[36m$(PROJECT)[m[31m [m[36m$(PROJECT)[m[31m.tar.gz[m[19;55H[K[49;79H2-9 [19;9H[?25h[?25l[49;76H22,1  [22;1H[?25h[?25l[49;77H4,12-25[24;25H[?25h[?25l[49;77H8,24-31[28;31H[?25h[49;1H[K[28;30H[?25l[49;66H^[[28;30H[49;66H  [28;31H[49;76H28,23-30      All[28;30H[?25h[?25l[49;66H:[28;30H[49;66H[K[49;1H:[?2004h[?25hw[?25l[?25hq[?25l[?25h[?25l[?1002l[?2004l"Makefile" 33L, 610C written[23;2t[23;1t[22;2t[22;1t[23;2t[23;1t
[?2004l[?1l>[?25h[?1049l[23;0;0tpsammon1@remote07:~/cs220/labs/lab1/exercises/3-multifile$ make dist
Makefile:24: *** missing separator (did you mean TAB instead of 8 spaces?).  Stop.
psammon1@remote07:~/cs220/labs/lab1/exercises/3-multifile$ make distvim Makefile
[?1000h[?2004h[?1049h[22;0;0t[?1h=[?2004h[1;49r[?12h[?12l[22;2t[22;1t[27m[23m[29m[m[H[2J[?25l[49;1H"Makefile" 33L, 610C[2;1H▽[6n[2;1H  [1;1H[>c]10;?]11;?[1;1H[36mPROJECT [m= quadr

[36mCFLAGS [m= -g -Wall -std=c11
[36mLDFLAGS [m= -lm
[36mSRC_FILES [m= main.c [35m\
        [mquadr.h [35m\
        [mquadr.c [35m\
        [mREADME [35m\
        [mtest.data [35m\
        [mMakefile

[36m$(PROJECT):[m     quadr.o main.o [36m$(LDFLAGS)[m
[31m                [m[36m$(CC)[m[31m  quadr.o main.o -o [m[36m$@

depend:[m
[31m        [m[36m$(CC)[m[31m -MM [m[36m$(CPPFLAGS)[m[31m *.c[m

[36mclean:[m
[31m                rm -f *.o [m[36m$(PROJECT)[m[31m [m[36m$(PROJECT)[m[31m.tar.gz[m

[36mdist:[27C$(PROJECT)[m.tar.gz

[36m$(PROJECT).tar.gz:[14C$(SRC_FILES)[m[24;33Htar -cf [36m$(PROJECT)[m.tar [36m$(SRC_FILES)[m[25;33Hgzip -f [36m$(PROJECT)[m.tar

[34m#automatically generated dependencies produced by make depend[m
[36mmain.o:[m[9Cmain.c quadr.h
[31m                gcc -std=c11 -g -Wall -c main.c[m

[36mquadr.o:[m[8Cquadr.c quadr.h
[31m                gcc -std=c11 -g -Wall -c quadr.c[m

[1m[34m~                                                                                            [35;1H~                                                                                            [36;1H~                                                                                            [37;1H~                                                                                            [38;1H~                                                                                            [39;1H~                                                                                            [40;1H~                                                                                            [41;1H~                                                                                            [42;1H~                                                                                            [43;1H~                                                                                            [44;1H~                                                                                            [45;1H~                                                                                            [46;1H~                                                                                            [47;1H~                                                                                            [48;1H~                                                                                            [m[49;76H28,23-30      All[28;30H[?25h[?1000l[?1002h[?25l[49;76H33,0-1  [33;1H[?25h[?25l[49;66H~@k[33;1H[49;66H   [32;48H[49;77H2,34-48[32;48H[?25h[?25l[49;76H27,22   [27;22H[?25h[?25l[49;77H3,19-24[23;24H[?25h[?25l[49;77H4,11[24;24H[?25h[?25l[49;80H3-33[24;33H[?25h[?25l[49;77H3,20-32[23;32H[?25h[?25l[49;66H~@k[23;32H[49;66H   [23;24H[49;79H19-24[23;24H[?25h[?25l[49;66Hi[23;24H[49;66H [23;19H[49;1H[1m-- INSERT --[m[49;13H[K[49;76H23,19[9CAll[23;19H[?25h[?25l[49;79H20-25[23;25H[?25h[?25l[49;80H1-33[23;33H[?25h[?25l[1C[36m[46m([9C)[m[49;80H2-34[23;34H[?25h[?25l[36m([9C)[m[49;80H1-33[23;33H[?25h[?25l[23;25H[36m$(SRC_FILES)[m[23;37H[K[49;80H0-25[23;25H[?25h[?25l[36m$(SRC_FILES)[m[23;31H[K[49;79H19   [23;19H[?25h[?25l      [36m$(SRC_FILES)[m[49;79H20-25[23;25H[?25h[?25l        [36m$(SRC_FILES)[m[49;80H1-33[23;33H[?25h[?25l[49;77H4,12-25[24;25H[?25h[?25l[49;80H3-33[24;33H[?25h[?25l[24;25Htar -cf [36m$(PROJECT)[m.tar [36m$(SRC_FILES)[m[24;60H[K[49;80H2-25[24;25H[?25h[?25l[24;17Htar -cf [36m$(PROJECT)[m.tar [36m$(SRC_FILES)[m[24;52H[K[49;80H1-17[24;17H[?25h[?25l[24;10Htar -cf [36m$(PROJECT)[m.tar [36m$(SRC_FILES)[m[24;45H[K[49;80H0   [24;10H[?25h[?25ltar -cf [36m$(PROJECT)[m.tar [36m$(SRC_FILES)[m[24;44H[K[49;79H9 [24;9H[?25h[?25ltar -cf [36m$(PROJECT)[m.tar [36m$(SRC_FILES)[m[24;43H[K[49;79H8[24;8H[?25h[?25ltar -cf [36m$(PROJECT)[m.tar [36m$(SRC_FILES)[m[24;42H[K[49;79H7[24;7H[?25h[?25ltar -cf [36m$(PROJECT)[m.tar [36m$(SRC_FILES)[m[24;41H[K[49;79H6[24;6H[?25h[?25ltar -cf [36m$(PROJECT)[m.tar [36m$(SRC_FILES)[m[24;40H[K[49;79H5[24;5H[?25h[?25ltar -cf [36m$(PROJECT)[m.tar [36m$(SRC_FILES)[m[24;39H[K[49;79H4[24;4H[?25h[?25ltar -cf [36m$(PROJECT)[m.tar [36m$(SRC_FILES)[m[24;38H[K[49;79H3[24;3H[?25h[?25ltar -cf [36m$(PROJECT)[m.tar [36m$(SRC_FILES)[m[24;37H[K[49;79H2[24;2H[?25h[?25ltar -cf [36m$(PROJECT)[m.tar [36m$(SRC_FILES)[m[24;36H[K[49;79H1[24;1H[?25h[?25l[23;48r[48;1H
[1;49r[23;1H[36m$(PROJECT).tar.gz:[m              [36m$(SRC_FILES)[mtar -cf [36m$(PROJECT)[m.tar [36m$(SRC_FILES)[m
[31m                                gzip -f [10C.tar[m[48;1H[1m[34m~                                                                                            [m[49;76H[K[49;76H23,33-45      All[23;34H[36m[46m([9C)[?25h[?25l[24;48r[m[24;1H[L[1;49r[23;45H[K[24;1H[31m        tar -cf [m[36m$(PROJECT)[m[31m.tar [m[36m$(SRC_FILES)[m[49;76H[K[49;76H24,2-9[8CAll[23;34H[36m([9C)[24;9H[?25h[?25l[m[31m        tar -cf [m[36m$(PROJECT)[m[31m.tar [m[36m$(SRC_FILES)[m[49;79H3-17[24;17H[?25h[?25l[31m        tar -cf [m[36m$(PROJECT)[m[31m.tar [m[36m$(SRC_FILES)[m[49;79H4-25[24;25H[?25h[?25l[31m        tar -cf [m[36m$(PROJECT)[m[31m.tar [m[36m$(SRC_FILES)[m[49;79H5-33[24;33H[?25h[?25l[49;77H5,27-55[25;55H[?25h[?25l[49;79H6-34 [25;34H[?25h[?25l[49;79H5-33[25;33H[?25h[?25l[25;25H[31mgzip -f[m[1C[36m$(PROJECT)[m[31m.tar[m[25;47H[K[49;79H4-25[25;25H[?25h[?25l[25;17H[31mgzip -f[m[1C[36m$(PROJECT)[m[31m.tar[m[25;39H[K[49;79H3-17[25;17H[?25h[?25l[25;9H[31mgzip -f[m[1C[36m$(PROJECT)[m[31m.tar[m[25;31H[K[49;79H2-9 [25;9H[?25h[?25lgzip -f [36m$(PROJECT)[m.tar[25;23H[K[49;79H1  [25;1H[?25h[?25l[24;48r[48;1H
[1;49r[24;1H[31m                                tar -cf [m[36m$(PROJECT)[m[31m.tar [m[36m$(SRC_FILES)[m[31mgzip -f [m[36m$(PROJECT)[m[31m.tar[m[48;1H[1m[34m~                                                                                            [m[49;76H[K[49;76H24,40-68      All[24;57H[36m[46m([9C)[?25h[?25l[25;48r[m[25;1H[L[1;49r[24;68H[K[25;1H[31m                                gzip -f [m[36m$(PROJECT)[m[31m.tar[m[49;76H[K[49;76H25,5-33[7CAll[24;57H[36m([9C)[25;33H[?25h[?25l[m[49;77H8,24-31[28;31H[?25h[?25l[49;76H30,1    [30;1H[?25h[49;1H[K[30;1H[?25l[49;66H^[[30;1H[49;66H  [30;1H[49;76H30,0-1[8CAll[30;1H[?25h[?25l[49;66H:[30;1H[49;66H[K[49;1H:[?2004h[?25hw[?25l[?25hq[?25l[?25h[?25l[?1002l[?2004l"Makefile" 33L, 602C written[23;2t[23;1t[22;2t[22;1t[23;2t[23;1t
[?2004l[?1l>[?25h[?1049l[23;0;0tpsammon1@remote07:~/cs220/labs/lab1/exercises/3-multifile$ vim Makefile[3Pmake dist
tar -cf quadr.tar main.c quadr.h quadr.c README test.data Makefile
gzip -f quadr.tar
psammon1@remote07:~/cs220/labs/lab1/exercises/3-multifile$ mktemp trm[K[Kemp
mktemp: too few X's in template ‘temp’
psammon1@remote07:~/cs220/labs/lab1/exercises/3-multifile$ mktemp tempx
mktemp: too few X's in template ‘tempx’
psammon1@remote07:~/cs220/labs/lab1/exercises/3-multifile$ mktemp tempx[KX
mktemp: too few X's in template ‘tempX’
psammon1@remote07:~/cs220/labs/lab1/exercises/3-multifile$ mktemp tempXXXX
tempmczs
psammon1@remote07:~/cs220/labs/lab1/exercises/3-multifile$ cd tempmczs [K
bash: cd: tempmczs: Not a directory
psammon1@remote07:~/cs220/labs/lab1/exercises/3-multifile$ rmdr[Kir tempmczs [K
rmdir: failed to remove 'tempmczs': Not a directory
psammon1@remote07:~/cs220/labs/lab1/exercises/3-multifile$ rmdir tempmczs[3Pcd[C[C[C[C[C[C[C[C[Cmktemp tempXXXX[K[K[K[K[K[K[K[K-d -t XXXX
/tmp/riyF
psammon1@remote07:~/cs220/labs/lab1/exercises/3-multifile$ mktemp -d -t XXXX[3Prmdir tempmczs[3Pcd[C[C[C[C[C[C[C[C[C[K[K[K[K[K[K[K[K/tmp/riyF/
psammon1@remote07:/tmp/riyF$ tar -xzf DISTR_PATH[K[K[K[K[K[K[K[K[K[K[K[K[K[K[K[K[K[K[Kcd /tmp/riyF/mktemp -d -t XXXX[3Prmdir tempmczs[3Pcd[C[C[C[C[C[C[C[C[Cmktemp tempXXXX[Kx[K[2Pake distvim Makefile[3Pmake distvim Makefilels[Kvim Makefile[8Pmakevim Makefilequadr.o: quadr.c quadr.h[2Pmain.o: main[C[C[C[C[C[C[C[C[C[C[11Pke dependvim Makefile[8Pmake./quadr < test.data[6Pvim[C[C[C[C[C[C[C[C[C[Cls[K./quadrls[Kmakevim Makefile[2Prm Makefills[Kvim Makefiecd ~/cs220/labs/lab1/exercises/3-multifile/[C[C[C[C[C[C[C[C[C[C[C[C[C[C[C[C[C[C[C[C[C[C[C[C[C[C[C[C[Cgit push[Kmerge lab4 -m 'merged lab4'push[Kcd ~/cs220/labs/lab1/exercises/3-multifile/
psammon1@remote07:~/cs220/labs/lab1/exercises/3-multifile$ ls
main.c	Makefile  quadr.c  quadr.o	 README    test.data
main.o	quadr	  quadr.h  quadr.tar.gz  tempmczs
psammon1@remote07:~/cs220/labs/lab1/exercises/3-multifile$ lscd ~/cs220/labs/lab1/exercises/3-multifile/[A[C[C[C[C[C[C[C[C[C[C[C[C[C[C[C[C[C[C[C[C[C[C[C[C[C[C[C[C[C[C[C[C[C[C[C[C[C[C[C[C[C[C[C[C[C[C[C[C[C[C[C[C[C/tmp/riyF/[K
[K[A[C[C[C[C[C[C[C[C[C[C[C[C[C[C[C[C[C[C[C[C[C[C[C[C[C[C[C[C[C[C[C[C[C[C[C[C[C[C[C[C[C[C[C[C[C[C[C[C[C[C[C[C[C[C[C[C[C[C[C[C[C[C[C[C[C[C[C[C[C[C[C[C~/cs220/labs/lab1/exercises/3-multifile/[A[C[C[C[C[C[C[C[C[C[C[C[C[C[C[C[C[C[C[C[C[C[C[C[C[C[C[C[C[C[C[C[C[C[C[C[C[C[C[C[C[C[C[C[C[C[C[C[C[C[C[C[C[C/tmp/riyF/[K
[K[A[C[C[C[C[C[C[C[C[C[C[C[C[C[C[C[C[C[C[C[C[C[C[C[C[C[C[C[C[C[C[C[C[C[C[C[C[C[C[C[C[C[C[C[C[C[C[C[C[C[C[C[C[C[C[C[C[C[C[C[C[C[C[C[C[C[C[C[C[C[C[C[C
psammon1@remote07:/tmp/riyF$ cd /tmp/riyF/ls[Kcd ~/cs220/labs/lab1/exercises/3-multifile/[C[C[C[C[C[C[C[C[C[C[C[C[C[C[C[C[C[C[C[C[C[C[C[C[C[C[C[C[C[C[C[C/tmp/riyF/[Kmktemp -d -t XXXX[4Pcd /tmp/riyF/~/cs220/labs/lab1/exercises/3-multifile/[C[C[C[C[C[C[C[C[C[C[C[C[C[C[C[C[C[C[C[C[C[C[C[C[C[C[C[C[Cls[Kcd /tmp/riyF/[Ktar -xzf ~/cs220/labs/lab1/exercises/3-multifile/
tar (child): /home/psammon1/cs220/labs/lab1/exercises/3-multifile/: Cannot read: Is a directory
tar (child): At beginning of tape, quitting now
tar (child): Error is not recoverable: exiting now

gzip: stdin: unexpected end of file
tar: Child returned status 2
tar: Error is not recoverable: exiting now
psammon1@remote07:/tmp/riyF$ tar -xzf ~/cs220/labs/lab1/exercises/3-multifile/quadr.tar.gz [K/
tar (child): /home/psammon1/cs220/labs/lab1/exercises/3-multifile/quadr.tar.gz/: Cannot open: Not a directory
tar (child): Error is not recoverable: exiting now

gzip: stdin: unexpected end of file
tar: Child returned status 2
tar: Error is not recoverable: exiting now
psammon1@remote07:/tmp/riyF$ tar -xzf ~/cs220/labs/lab1/exercises/3-multifile/quadr.tar.gz/[K[K[K[K[K[K[K[K[K[K[K[K[K
tar (child): /home/psammon1/cs220/labs/lab1/exercises/3-multifile/: Cannot read: Is a directory
tar (child): At beginning of tape, quitting now
tar (child): Error is not recoverable: exiting now

gzip: stdin: unexpected end of file
tar: Child returned status 2
tar: Error is not recoverable: exiting now
psammon1@remote07:/tmp/riyF$ tar -xzf ~/cs220/labs/lab1/exercises/3-multifile/quadr.tar.gz/[1P/cs220/labs/lab1/exercises/3-multifile/quadr.tar.gz/[C[C[C[C[C[C[C[C[C[C[C[C[C[C[C[C[C[C[C[C[C[C[C[C[C[C[C[C[C[C[C[C[C[C[C[C[C[C
tar (child): /cs220/labs/lab1/exercises/3-multifile/quadr.tar.gz/: Cannot open: No such file or directory
tar (child): Error is not recoverable: exiting now
tar: Child returned status 2
tar: Error is not recoverable: exiting now
psammon1@remote07:/tmp/riyF$ tar -xzf /cs220/labs/lab1/exercises/3-multifile/quadr.tar.gz/[C[C[C[C[C[C[C[C[C[C[C[C[C[C[C[C[C[C[C[C[C[C[C[C[C[C[C[C[C[C[C[C[C[C[C[C[C[C[12P~/cs220/labs/lab1/exercises/3-multifile/quadr.tar.gz/[K[C[C[C[C[C[C[C[C[C[C[C[C[C[C[C[C[C[C[C[C[C[C[C[C[C[C[C[C[Ccd /tmp/riyF/[Kls[Kcd ~/cs220/labs/lab1/exercises/3-multifile/
psammon1@remote07:~/cs220/labs/lab1/exercises/3-multifile$ cd ~/cs220/labs/lab1/exercises/3-multifile/[A[C[C[C[C[C[C[C[C[C[C[C[C[C[C[C[C[C[C[C[C[C[C[C[C[C[C[C[C[C[C[C[C[C[C[C[C[C[C[C[C[C[C[C[C[C[C[C[C[C[Ctar -xzf /cs220/labs/lab1/exercises/3-multifile/quadr.tar.gz/[A[C[C[C[C[C[C[C[C[C[C[C[C[C[C[C[C[C[C[C[C[C[C[C[C[C[C[C[C[C[C[C[C[C[C[C[C[C[C[C[C[C~/cs220/labs/lab1/exercise[12Ps/3-multifile/quadr.tar.gz/[K[A[C[C[C[C[C[C[C[C[C[C[C[C[C[C[C[C[C[C[C[C[C[C[C[C[C[C[C[C[C[C[C[C[C[C[C[C[C[C[C[C[C[C[C[C[21Pcd /tmp/riyF/
[K[A[C[C[C[C[C[C[C[C[C[C[C[C[C[C[C[C[C[C[C[C[C[C[C[C[C[C[C[C[C[C[C[C[C[C[C[C[C[C[C[C[C[C[C[C[C[C[C[C[C[C[C[C[C[C[C[C[C[C[C[C[C[C[C[C[C[C[C[C[C[C[C[Cls[Kcd ~/cs220/labs/lab1/exercises/3-multifile/[A[C[C[C[C[C[C[C[C[C[C[C[C[C[C[C[C[C[C[C[C[C[C[C[C[C[C[C[C[C[C[C[C[C[C[C[C[C[C[C[C[C[C[C[C[C[C[C[C[C[C[C[C[C/tmp/riyF/[K
[K[A[C[C[C[C[C[C[C[C[C[C[C[C[C[C[C[C[C[C[C[C[C[C[C[C[C[C[C[C[C[C[C[C[C[C[C[C[C[C[C[C[C[C[C[C[C[C[C[C[C[C[C[C[C[C[C[C[C[C[C[C[C[C[C[C[C[C[C[C[C[C[C[Cmktemp -d -t XXXX[3Prmdir tempmczs[3Pcd[C[C[C[C[C[C[C[C[Cmktemp tempXXXX[Kx[K[2Pake distvim Makefile[K[K[K[K[K[K[K[K[K[K[K[Kcat Make[Kke[K[Kefile
PROJECT = quadr

CFLAGS = -g -Wall -std=c11
LDFLAGS = -lm  
SRC_FILES = main.c \
	quadr.h \
	quadr.c \
	README \
	test.data \
	Makefile

$(PROJECT):	quadr.o main.o $(LDFLAGS)
		$(CC)  quadr.o main.o -o $@

depend:
	$(CC) -MM $(CPPFLAGS) *.c

clean:
		rm -f *.o $(PROJECT) $(PROJECT).tar.gz

dist:				$(PROJECT).tar.gz

$(PROJECT).tar.gz:		$(SRC_FILES)
				tar -cf $(PROJECT).tar $(SRC_FILES)
				gzip -f $(PROJECT).tar

#automatically generated dependencies produced by make depend
main.o:		main.c quadr.h
		gcc -std=c11 -g -Wall -c main.c

quadr.o:	quadr.c quadr.h
		gcc -std=c11 -g -Wall -c quadr.c

psammon1@remote07:~/cs220/labs/lab1/exercises/3-multifile$ exit

Script done on 2020-09-24 17:33:57-04:00 [COMMAND_EXIT_CODE="0"]
